

F                                       35,35,35


WE         ./textures/neon_a.png 
SO               ./textures/neon1.png
        EA       ./textures/neon_b.png
	
C 5,5,5

NO ./textures/neon2.png
111111111111111111111111
100000000000000000001111
111110000100110000000001
1000000001000100000  001
101110000100000000000001
101100000000001111111001
1010000011110000000000001
1000000000000000111111001
110000N0000000000011 1001
11111111111111111111 1111
